George	Alexander
Tina	Young
Shirley	Hall
Margaret	Reed
Kathy	Roberts
William	Wilson
Barbara	King
Wayne	James
Katherine	Adams
Lori	Ward
Willie	Martin
Irene	Hughes
Johnny	Howard
Ronald	Lopez
Judith	Green
Diana	Bailey
Bonnie	Diaz
Sandra	Lewis
Emily	Bell
Peter	Rogers
Martin	Torres
Kathleen	Sanders
Ryan	Russell
Bobby	Cox
Betty	Rivera
Roger	Rodriguez
Joshua	Campbell
Ruth	Scott
Richard	Gray
Donald	Smith
Stephen	Lee
Phillip	Phillips
Rose	Brown
Philip	Clark
Beverly	Brooks
Annie	Parker
Steve	Hill
Ann	Gonzales
Nicole	Moore
Julia	Barnes
Jesse	Carter
Angela	Robinson
Charles	Kelly
Debra	Wright
Jose	Jackson
Catherine	Cooper
Joyce	Washington
Jane	Gonzalez
Jason	Perez
Gerald	Jenkins
Juan	Murphy
Fred	Mitchell
Lois	Williams
Kathryn	Peterson
Mark	Ramirez
Nicholas	Cook
Jean	Martinez
Carolyn	Henderson
Martha	Taylor
Jack	Harris
Victor	Bryant
Amanda	White
Virginia	Hernandez
Linda	Thomas
Joan	Coleman
Roy	Price
Chris	Butler
Henry	Johnson
Phyllis	Turner
Anthony	Watson
Elizabeth	Foster
Joe	Perry
Jeremy	Wood
Eric	Collins
Brian	Simmons
Lawrence	Bennett
Carl	Ross
Dennis	Walker
Tammy	Long
John	Morgan
Earl	Jones
Doris	Nelson
Ashley	Stewart
Harry	Allen
Christopher	Garcia
Kevin	Thompson
Theresa	Sanchez
Thomas	Anderson
Teresa	Patterson
Billy	Edwards
Larry	Richardson
Alice	Griffin
Julie	Davis
Louise	Baker
Judy	Morris
Nancy	Flores
Melissa	Evans
Ralph	Miller
Marilyn	Powell
Juan	Washington
Ruth	Parker
Kathryn	Wright
Louis	Griffin
Kathleen	James
Kimberly	Moore
Janice	Roberts
Shirley	Price
Steve	Bryant
Benjamin	Morris
Martin	Alexander
Charles	Brown
Kelly	Robinson
Nancy	Torres
Matthew	Brooks
Jimmy	Martin
Ann	Green
Rebecca	Martinez
Philip	Davis
Ralph	Walker
Julie	Flores
Theresa	Thompson
Jacqueline	Clark
Jane	Sanders
Ryan	Johnson
Lori	Ramirez
Susan	Barnes
Roy	Russell
Janet	Hall
Alan	Adams
Jack	Jackson
Linda	Taylor
Victor	Evans
Raymond	Anderson
Joseph	Murphy
Sandra	Williams
George	Hernandez
Mark	Howard
Nicholas	Kelly
Russell	Cook
Samuel	Diaz
Sharon	Collins
Jessica	Powell
Julia	Jenkins
Christine	Simmons
Nicole	Miller
Stephen	Cooper
Fred	Watson
Eugene	Edwards
Rachel	Henderson
Ruby	White
John Salchichon